00000000000200000000000000000000
00000000000200000000000000000000
00000000000200000000000000000000
00000000000200000051101110111011
00051100000200000022202270822000
0052260000020000v022202270822210
1122600000020000v022204270800000
2200000000020000v022230270801111
2000009000020v00v022220270802222
0005112100020v00v022260270802000
0052222200020v000022605270802000
0511111000020v000026052270800010
0422226000020v0v0020522270811120
304226000002000v0020220270822229
230460000002000v0020422270822222
223000081002000v0023000470000000
222305082000000v0022300000000000
22222299290000000022230599930000