a0000000000000000000020000000002
00000000000000000000020000000002
11300000000000000000020000000002
22230000000000000000020000010002
22223050000300000005020vvv020002
22222127008211010116020vvv020002
22222227998222929260520vvv020002
22222222222222222605220vvv020002
00000027000000226052220vvv023002
00000027000000260522200vvv022302
00000027000000605222000vvv020002
00000000000000052220000vvv020002
00990000005030522200000vvv020052
00221111112121222000000000020522
0000000020000000000000001102000z
3000000000000000000001102202000z
2300000010000000001102202202300z
2230059920030009092202202202230z