0000000000000000000000000000000z
000000000000000000v00000v000000z
000101130000000000v00000v000000z
100000021130000000v00v00v00v000z
210000000223000000v00v00v00v000z
222221000222300000v00v00v00v000z
000000000222230000v00v00v00v0042
000000011222223050000v0000000002
00090912222222226000000000000002
00121222220000000000000000000002
00000002220000000000000000000002
10000000220000000000000000000002
21909000020000000000000000000002
22212100020000000000000000000002
00000000020000000000000000000002
00000001020000000000000000000002
00000102020000000000000000000002
a0019292929999999999999999999992